TES	= "countries/Test.txt"

##圣三一##
TRI = "countries/Trinity_School.txt"
SRS = "countries/South_Recover_State.txt"
CRS = "countries/Center_Recover_State.txt"
NRS = "countries/North_Recover_State.txt"

#########
##缓冲区##

#阿里乌斯赛区
NML = "countries/No_Man_Land.txt"
NGW = "countries/No_Gov_WasteLand.txt"
MRD = "countries/MotorRaiders.txt"
SCR = "countries/ScrapCollector.txt"
LUS = "countries/LupinusSchool.txt"
HTS = "countries/HyacinthusSchool.txt"
AMS = "countries/AnemoneSchool.txt"
LAS = "countries/LinariaSchool.txt"
HPF = "countries/HiponiaExpeditionaryForce.txt"
ASC = "countries/AriusStudentCouncil.txt"
ALF = "countries/AriusLiberationFront.txt"
ARA = "countries/AriusArmy.txt"
AAS = "countries/AriusAdeptus.txt"
ARU = "countries/AriusRevengeUnion.txt"
ARM = "countries/AriusMarines.txt"

#圣三一赛区
PBH = "countries/PetarBranch.txt"
CLG = "countries/CatalanGang.txt"
KPW = "countries/KaiserPMC_WZ.txt"
KCG = "countries/KasselCollege.txt"
TID = "countries/TrinityIntelligenceDepartment.txt"
WHG = "countries/WaterHelmetGang.txt"
CHG = "countries/CenterHelmetGang.txt"
FHG = "countries/FieldHelmetGang.txt"
MHG = "countries/MotorHelmetGang.txt"
OHG = "countries/WarriorHelmetGang.txt"
THG = "countries/TradeHelmetGang.txt"
RHG = "countries/ResearchHelmetGang.txt"
DHG = "countries/RoadHelmetGang.txt"

#格黑娜赛区
BPE = "countries/Biosphere_3.txt"
MCT = "countries/MechanicalTribe.txt"
VST = "countries/ValkyrieSmugglingTeam.txt"
GSO = "countries/GehennaOpeationCommand.txt"
SEO = "countries/SixtyEightOffice.txt"
SCD = "countries/StudentCouncilDelegation.txt"
NPS = "countries/Nopacts.txt"
BGS = "countries/BlackGuards.txt"
BLM = "countries/BlackMarket.txt"
GCO = "countries/GehennaCeasefireOT.txt"
TCO = "countries/TrinityCeasefireOT.txt"
DCP = "countries/DisciplinaryOutPost.txt"
BLS = "countries/BlackLilySchool.txt"
FEA = "countries/FreeArmy.txt"
WSL = "countries/WasteLand.txt"
MOR = "countries/MysteryObserver.txt"

##阿拜多斯赛区
GDF = "countries/GreenDefender.txt"
HLR = "countries/HighLanderRegiment.txt"
ELD = "countries/EndlessDesert.txt"
OMC = "countries/ObsidianPMC.txt"
IAA = "countries/IcarusAviationAcademy.txt"
TAE = "countries/TheAncientEra.txt"
UDF = "countries/UnitedFront.txt"
MTR = "countries/MountainRaiders.txt"
RTB = "countries/RocketTribe.txt"
HTB = "countries/HelicopterTribe.txt"
AOS = "countries/AstraObserveStation.txt"
EGD = "countries/EquipmentGraveyard.txt"
FGD = "countries/FlameGround.txt"

#东大陆上半区
GEH = "countries/Gehenna.txt"
ABY = "countries/Abydos.txt"
WLH = "countries/Wlidhunt.txt"
HIL = "countries/Highland.txt"
ERZ = "countries/ErzMusic.txt"
RHM = "countries/Rheinmetall.txt"
MAS = "countries/Mars.txt"
OSG = "countries/OasisGang.txt"
FSG = "countries/ForestSonGang.txt"
RBG = "countries/RibbonGang.txt"
BBG = "countries/BigBubbleGang.txt"
LSG = "countries/LongSailGang.txt"

#西大陆赛区
RDR = "countries/RedDragonRoyal.txt"
YSL = "countries/Yusula.txt"
SHS = "countries/SevenHillsSaint.txt"
DTG = "countries/Dartagnan.txt"
SFB = "countries/SaintFabien.txt"